{
  "\"": 0,
  "'": 1,
  "(": 2,
  ")": 3,
  "+": 4,
  ",": 5,
  "-": 6,
  ".": 7,
  "/": 8,
  "0": 9,
  "1": 10,
  "2": 11,
  "3": 12,
  "4": 13,
  "5": 14,
  "6": 15,
  "7": 16,
  "8": 17,
  "9": 18,
  ":": 19,
  "=": 20,
  "?": 21,
  "@": 22,
  "A": 23,
  "B": 24,
  "C": 25,
  "D": 26,
  "E": 27,
  "F": 28,
  "G": 29,
  "H": 30,
  "I": 31,
  "J": 32,
  "K": 33,
  "L": 34,
  "M": 35,
  "N": 36,
  "O": 37,
  "P": 38,
  "Q": 39,
  "R": 40,
  "S": 41,
  "T": 42,
  "U": 43,
  "V": 44,
  "W": 45,
  "X": 46,
  "Y": 47,
  "Z": 48
}